"ah" = (/obj/machinery/door/airlock/maintenance/external,/obj/effect/mapping_helpers/airlock/locked,/obj/structure/barricade/wooden/snowed,/turf/open/floor/plating/airless,/area/space)
"al" = (/obj/machinery/atmospherics/pipe/simple/scrubbers/hidden/layer4{dir = 6},/turf/open/floor/plating/rust,/area/space)
"aE" = (/obj/machinery/atmospherics/pipe/simple/scrubbers/hidden/layer4{dir = 8},/turf/open/floor/plating/airless,/area/space)
"aH" = (/obj/effect/turf_decal/techfloor{dir = 1},/obj/effect/turf_decal/spline/fancy/opaque/red{dir = 1},/obj/machinery/light/dim/directional/north,/obj/structure/cable{icon_state = "6-8"},/obj/effect/decal/cleanable/dirt/dust,/turf/open/floor/plasteel/tech,/area/space)
"aO" = (/obj/structure/fence,/turf/open/floor/plating/asteroid/snow/icemoon,/area/overmap_encounter/planetoid/cave/explored)
"aS" = (/obj/effect/turf_decal/siding/wood/end{dir = 4},/obj/structure/cable{icon_state = "4-8"},/turf/open/floor/wood,/area/space)
"ba" = (/obj/structure/chair/sofa/grey/corpo/right/directional/south,/obj/effect/decal/cleanable/dirt/dust,/obj/effect/decal/cleanable/insectguts,/turf/open/floor/carpet/black,/area/space)
"bm" = (/obj/effect/spawner/structure/window,/obj/effect/decal/cleanable/glass,/turf/open/floor/plating/airless,/area/space)
"bQ" = (/obj/effect/decal/cleanable/blood/footprints{dir = 8; pixel_y = -3; pixel_x = -13},/obj/effect/decal/cleanable/blood/drip{pixel_y = 15; pixel_x = 20},/obj/effect/decal/cleanable/dirt/dust,/obj/machinery/door/airlock/grunge{dir = 4},/obj/effect/mapping_helpers/airlock/locked,/turf/open/floor/plasteel/tech/grid,/area/space)
"ca" = (/obj/effect/turf_decal/industrial/hatch/yellow,/obj/effect/turf_decal/siding/thinplating{dir = 5},/obj/machinery/portable_atmospherics/canister,/turf/open/floor/plasteel/mono/dark,/area/space)
"cg" = (/obj/structure/chair/sofa/grey/corpo/left/directional/south,/obj/effect/decal/cleanable/cobweb/cobweb2,/turf/open/floor/carpet/black,/area/space)
"cm" = (/obj/structure/closet/emcloset/empty,/obj/item/bodypart/chest,/obj/item/bodypart/head/ipc{pixel_y = -5},/obj/item/bodypart/l_arm/ipc,/obj/item/bodypart/r_arm{pixel_x = 2; pixel_y = -3},/obj/item/bodypart/leg/left{pixel_x = -5; pixel_y = 9},/obj/item/bodypart/leg/right/ipc{pixel_x = 2; pixel_y = 6},/obj/item/organ/heart/cybernetic,/obj/effect/decal/cleanable/blood/old{pixel_y = -10},/obj/effect/decal/cleanable/blood/gibs/old,/obj/effect/decal/cleanable/dirt/dust,/obj/effect/decal/cleanable/oil,/turf/open/floor/plasteel/tech,/area/space)
"cB" = (/obj/effect/spawner/structure/window/hollow/reinforced/middle{dir = 4},/obj/structure/cable{icon_state = "4-10"},/turf/open/floor/plating/airless,/area/space)
"cH" = (/obj/structure/table,/obj/item/clothing/head/hardhat{pixel_y = 7; pixel_x = 5},/obj/item/clothing/glasses/welding,/turf/open/floor/plasteel/tech,/area/space)
"dd" = (/obj/machinery/vending/sustenance,/turf/open/floor/carpet/black,/area/space)
"dh" = (/obj/effect/turf_decal/techfloor/orange{dir = 8},/turf/open/floor/plasteel/tech,/area/space)
"dJ" = (/obj/structure/fence{dir = 8},/turf/open/floor/plating/asteroid/snow/icemoon,/area/overmap_encounter/planetoid/cave/explored)
"dL" = (/obj/machinery/portable_atmospherics/canister/bz{gas_type = null},/obj/effect/decal/cleanable/dirt/dust,/turf/open/floor/plating/rust,/area/space)
"ee" = (/obj/effect/decal/cleanable/dirt/dust,/turf/open/floor/plating/airless,/area/space)
"eu" = (/obj/effect/spawner/bunk_bed,/turf/open/floor/plating/airless,/area/space)
"eO" = (/obj/machinery/computer/station_alert/retro{dir = 1},/obj/effect/decal/cleanable/dirt/dust,/turf/open/floor/plasteel/tech,/area/space)
"fm" = (/obj/machinery/atmospherics/pipe/simple/scrubbers/hidden/layer4{dir = 9},/turf/open/floor/plating/asteroid/snow/icemoon,/area/overmap_encounter/planetoid/cave/explored)
"fB" = (/turf/closed/wall/r_wall,/area/space)
"fL" = (/turf/closed/wall,/area/space)
"gd" = (/obj/machinery/suit_storage_unit/independent/engineering,/obj/effect/turf_decal/industrial/hatch/yellow,/obj/effect/turf_decal/siding/thinplating{dir = 6},/turf/open/floor/plasteel/mono/dark,/area/space)
"gs" = (/obj/machinery/washing_machine,/obj/effect/decal/cleanable/cobweb,/turf/open/floor/plating/airless,/area/space)
"gz" = (/obj/effect/spawner/structure/window/hollow/reinforced/middle,/turf/open/floor/plating/rust,/area/space)
"gB" = (/obj/structure/frame/machine,/obj/effect/turf_decal/techfloor/orange{dir = 4},/turf/open/floor/plating/airless,/area/space)
"gV" = (/obj/machinery/door/airlock/maintenance,/obj/effect/mapping_helpers/airlock/locked,/obj/structure/cable{icon_state = "1-2"},/turf/open/floor/plasteel/tech/grid,/area/space)
"gZ" = (/obj/structure/window/reinforced{dir = 4},/obj/effect/turf_decal/techfloor/orange{dir = 1},/obj/structure/sign/warning/nosmoking{pixel_y = 32},/obj/machinery/computer/monitor/retro{dir = 8},/obj/structure/cable{icon_state = "0-8"},/turf/open/floor/plasteel/tech,/area/space)
"he" = (/obj/machinery/door/airlock/grunge,/turf/open/floor/plasteel/tech/grid,/area/space)
"hB" = (/obj/machinery/door/airlock/maintenance{dir = 8},/obj/effect/mapping_helpers/airlock/locked,/obj/structure/barricade/wooden,/turf/open/floor/plating/airless,/area/space)
"hQ" = (/obj/structure/closet/crate/trashcart,/obj/effect/turf_decal/industrial/hatch/yellow,/obj/effect/turf_decal/siding/thinplating{dir = 8},/obj/item/circular_saw/augment,/obj/item/ammo_casing/a44roum/hp,/turf/open/floor/plasteel/mono/dark,/area/space)
"hR" = (/obj/structure/girder/reinforced,/turf/open/floor/plating/snowed/temperatre{initial_gas_mix = "ICEMOON_ATMOS"},/area/space)
"iK" = (/obj/structure/cable{icon_state = "1-8"},/obj/item/ammo_casing/a44roum/hp,/obj/effect/decal/cleanable/dirt/dust,/turf/open/floor/plating/rust,/area/space)
"iN" = (/obj/effect/decal/cleanable/dirt/dust,/obj/structure/cable{icon_state = "5-10"},/turf/open/floor/plasteel/tech/techmaint,/area/space)
"iR" = (/obj/structure/cable{icon_state = "2-8"},/turf/open/floor/plasteel/tech/techmaint,/area/space)
"jh" = (/obj/machinery/power/port_gen/pacman{anchored = 1},/obj/machinery/power/terminal{dir = 1},/obj/effect/decal/cleanable/dirt/dust,/turf/open/floor/plating/rust,/area/space)
"jn" = (/obj/structure/closet/firecloset/empty,/obj/effect/decal/cleanable/cobweb/cobweb2,/turf/open/floor/plating/airless,/area/space)
"jw" = (/obj/effect/turf_decal/techfloor{dir = 6},/obj/effect/turf_decal/spline/fancy/opaque/red{dir = 6},/obj/structure/cable{icon_state = "4-9"},/obj/effect/decal/cleanable/dirt/dust,/turf/open/floor/plasteel/tech,/area/space)
"jX" = (/obj/structure/salvageable/safe_server,/obj/effect/turf_decal/techfloor/orange,/turf/open/floor/plasteel/tech{initial_gas_mix = "ICEMOON_ATMOS"},/area/space)
"jY" = (/obj/effect/spawner/structure/window/hollow/reinforced/middle{dir = 4},/turf/open/floor/plating/airless,/area/space)
"kp" = (/turf/open/floor/plating/asteroid/snow/icemoon,/area/overmap_encounter/planetoid/cave/explored)
"kz" = (/obj/effect/decal/cleanable/dirt/dust,/obj/structure/cable{icon_state = "5-10"},/turf/open/floor/plasteel/mono/dark{initial_gas_mix = "ICEMOON_ATMOS"},/area/space)
"lb" = (/obj/structure/table,/obj/structure/sign/warning/xeno_mining{pixel_x = -32},/obj/effect/decal/cleanable/dirt/dust,/obj/item/stack/ore/salvage/scrapuranium{pixel_y = 2; pixel_x = -4},/obj/item/clothing/mask/gas{pixel_x = 6},/obj/item/screwdriver{pixel_x = -8; pixel_y = 1},/obj/effect/turf_decal/techfloor,/turf/open/floor/plasteel/tech/grid,/area/space)
"lw" = (/obj/structure/fence/door,/turf/open/floor/plating/asteroid/snow/icemoon,/area/overmap_encounter/planetoid/cave/explored)
"lD" = (/obj/structure/cable{icon_state = "1-2"},/obj/structure/cable{icon_state = "2-5"},/turf/open/floor/plasteel/tech/techmaint,/area/space)
"lH" = (/obj/effect/turf_decal/techfloor/orange{dir = 10},/obj/effect/decal/cleanable/dirt/dust,/obj/structure/cable{icon_state = "0-8"},/obj/machinery/power/terminal{dir = 4},/turf/open/floor/plasteel/tech,/area/space)
"lT" = (/obj/structure/flora/rock/pile,/turf/open/floor/plating/asteroid/snow/icemoon,/area/overmap_encounter/planetoid/cave/explored)
"mA" = (/obj/structure/cable{icon_state = "1-2"},/obj/structure/sign/warning/incident{pixel_x = -32},/turf/open/floor/plasteel/tech/techmaint,/area/space)
"mH" = (/obj/structure/flora/grass/green,/turf/open/floor/plating/asteroid/snow/icemoon,/area/overmap_encounter/planetoid/cave/explored)
"mT" = (/obj/machinery/power/smes,/obj/structure/cable{icon_state = "0-4"},/obj/effect/decal/cleanable/dirt/dust,/turf/open/floor/plating/rust,/area/space)
"nl" = (/obj/effect/turf_decal/siding/wood{dir = 10},/obj/effect/turf_decal/siding/wood/corner{dir = 4},/obj/effect/decal/cleanable/dirt/dust,/obj/structure/noticeboard{pixel_x = -32},/turf/open/floor/wood,/area/space)
"ov" = (/obj/machinery/door/airlock/security{dir = 4},/obj/effect/mapping_helpers/airlock/locked,/obj/structure/cable{icon_state = "4-8"},/turf/open/floor/plasteel/stairs{dir = 4},/area/space)
"oO" = (/obj/structure/cable{icon_state = "4-8"},/obj/structure/sign/poster/contraband/missing_gloves{pixel_y = 32},/obj/effect/decal/cleanable/dirt/dust,/obj/effect/decal/cleanable/garbage,/turf/open/floor/plating/airless,/area/space)
"oU" = (/obj/structure/window/reinforced{dir = 4},/obj/structure/salvageable/computer{dir = 8},/obj/effect/turf_decal/techfloor/orange{dir = 1},/obj/structure/sign/warning/nosmoking{pixel_y = 32},/turf/open/floor/plasteel/tech,/area/space)
"pb" = (/obj/effect/turf_decal/techfloor{dir = 10},/obj/item/shard{pixel_x = -1; pixel_y = 4},/obj/item/shard{pixel_x = 4},/obj/effect/turf_decal/spline/fancy/opaque/red{dir = 10},/obj/structure/frame/computer/retro{dir = 1},/obj/effect/decal/cleanable/dirt/dust,/turf/open/floor/plasteel/tech,/area/space)
"pw" = (/obj/structure/sign/poster/official/nanotrasen_logo{pixel_y = 32; pixel_x = 32},/turf/open/floor/plating/snowed/temperatre{initial_gas_mix = "ICEMOON_ATMOS"},/area/overmap_encounter/planetoid/cave/explored)
"qi" = (/obj/structure/sign/warning/coldtemp{pixel_x = -32},/obj/structure/closet/crate/secure/loot,/obj/effect/turf_decal/techfloor{dir = 1},/turf/open/floor/plasteel/tech/grid,/area/space)
"qj" = (/obj/structure/salvageable/autolathe,/turf/open/floor/plasteel/tech/techmaint,/area/space)
"qp" = (/obj/machinery/atmospherics/components/unary/passive_vent/layer4,/turf/open/floor/plating/asteroid/snow/icemoon,/area/overmap_encounter/planetoid/cave/explored)
"qA" = (/obj/structure/window/reinforced{dir = 4},/obj/effect/turf_decal/techfloor/orange,/obj/structure/table,/obj/effect/landmark/mission_poi/main,/turf/open/floor/plasteel/tech,/area/space)
"sO" = (/obj/machinery/door/airlock/external/glass{dir = 4},/turf/open/floor/plasteel/tech/grid,/area/space)
"tb" = (/turf/open/floor/plasteel/mono/dark{initial_gas_mix = "ICEMOON_ATMOS"},/area/space)
"tg" = (/obj/machinery/light/dim/directional/east,/turf/open/floor/plasteel/tech/techmaint,/area/space)
"tq" = (/turf/closed/mineral/snowmountain/icemoon,/area/overmap_encounter/planetoid/cave/explored)
"tv" = (/obj/effect/turf_decal/techfloor/orange{dir = 10},/turf/open/floor/plasteel/tech,/area/space)
"ub" = (/obj/structure/sign/warning/securearea{pixel_y = 32},/obj/structure/flora/rock/pile/icy,/turf/open/floor/plating/asteroid/snow/icemoon,/area/overmap_encounter/planetoid/cave/explored)
"uf" = (/obj/effect/turf_decal/siding/thinplating{dir = 8},/obj/effect/decal/cleanable/dirt/dust,/obj/structure/closet/crate/large,/turf/open/floor/plasteel/mono/dark,/area/space)
"vj" = (/turf/open/floor/plasteel/tech/techmaint,/area/space)
"vV" = (/obj/structure/sign/poster/official/nanotrasen_logo{pixel_y = 32},/turf/open/floor/plating/asteroid/snow/icemoon,/area/overmap_encounter/planetoid/cave/explored)
"wE" = (/obj/structure/marker_beacon,/turf/open/floor/plating/snowed/temperatre{initial_gas_mix = "ICEMOON_ATMOS"},/area/overmap_encounter/planetoid/cave/explored)
"wG" = (/obj/structure/bed/bunk,/obj/item/stack/sheet/metal,/obj/structure/sign/poster/contraband/engis_unite{pixel_y = 32},/obj/effect/decal/cleanable/dirt/dust,/turf/open/floor/plating/rust,/area/space)
"xN" = (/obj/structure/chair/plastic{dir = 4},/obj/effect/mob_spawn/human/engineer{oxy_damage = 60; brute_damage = 90},/obj/effect/decal/cleanable/blood/gibs/up,/obj/effect/decal/cleanable/blood/gibs/down,/obj/effect/decal/cleanable/blood/innards,/obj/effect/decal/cleanable/dirt/dust,/turf/open/floor/plating/airless,/area/space)
"yt" = (/obj/effect/turf_decal/techfloor/orange/corner,/obj/effect/decal/cleanable/cobweb,/turf/open/floor/plating/airless,/area/space)
"yP" = (/obj/structure/cable{icon_state = "1-2"},/turf/open/floor/plasteel/tech/techmaint,/area/space)
"zG" = (/obj/structure/sink{pixel_y = 18},/obj/machinery/light/small/directional/south,/turf/open/floor/plasteel/freezer,/area/space)
"Aa" = (/obj/effect/turf_decal/techfloor,/obj/effect/turf_decal/spline/fancy/opaque/red,/obj/effect/decal/cleanable/dirt/dust,/turf/open/floor/plasteel/tech,/area/space)
"An" = (/obj/effect/turf_decal/techfloor{dir = 9},/obj/effect/turf_decal/spline/fancy/opaque/red{dir = 9},/obj/structure/cable{icon_state = "0-4"},/obj/machinery/power/apc/auto_name/directional/west,/obj/structure/chair/plastic{dir = 4},/obj/effect/decal/cleanable/dirt/dust,/obj/structure/sign/poster/official{pixel_y = 32},/turf/open/floor/plasteel/tech,/area/space)
"Av" = (/obj/effect/decal/cleanable/dirt/dust,/obj/effect/decal/cleanable/glass,/turf/open/floor/plasteel/tech/techmaint,/area/space)
"Bc" = (/obj/structure/table,/obj/item/weldingtool,/obj/effect/decal/cleanable/dirt/dust,/turf/open/floor/plasteel/tech,/area/space)
"Bw" = (/obj/structure/fluff/fokoff_sign,/turf/open/floor/plating/asteroid/snow/icemoon,/area/overmap_encounter/planetoid/cave/explored)
"BD" = (/obj/machinery/power/smes,/obj/structure/window/reinforced{dir = 4},/obj/effect/turf_decal/techfloor/orange,/obj/effect/decal/cleanable/dirt/dust,/obj/structure/cable{icon_state = "0-5"},/turf/open/floor/plasteel/tech,/area/space)
"Ce" = (/obj/machinery/light/dim/directional/east,/obj/machinery/atmospherics/components/unary/passive_vent/layer4{dir = 4},/turf/open/floor/plasteel/mono/dark{initial_gas_mix = "ICEMOON_ATMOS"},/area/space)
"CA" = (/obj/machinery/atmospherics/pipe/manifold/scrubbers/hidden/layer4{dir = 1},/obj/effect/decal/cleanable/dirt/dust,/turf/open/floor/plating/airless,/area/space)
"CW" = (/obj/effect/turf_decal/siding/wood/end{dir = 1},/obj/structure/cable{icon_state = "6-8"},/turf/open/floor/wood,/area/space)
"Dc" = (/obj/machinery/door/airlock/maintenance,/obj/effect/mapping_helpers/airlock/locked,/obj/structure/barricade/wooden/crude,/obj/machinery/atmospherics/pipe/simple/scrubbers/hidden/layer4{dir = 9},/turf/open/floor/plating/rust,/area/space)
"Do" = (/obj/machinery/atmospherics/pipe/simple/scrubbers/hidden/layer4{dir = 9},/turf/open/floor/plating/airless,/area/space)
"DC" = (/obj/effect/turf_decal/techfloor/orange{dir = 9},/obj/structure/cable{icon_state = "4-9"},/turf/open/floor/plasteel/tech,/area/space)
"DY" = (/obj/machinery/door/airlock/glass,/turf/open/floor/plasteel/tech/grid,/area/space)
"Ey" = (/turf/open/floor/plating/airless,/area/space)
"EN" = (/obj/structure/closet/emcloset,/obj/effect/decal/cleanable/dirt/dust,/obj/effect/turf_decal/techfloor{dir = 1},/obj/structure/sign/poster/official/safety_internals{pixel_y = -32},/turf/open/floor/plasteel/tech/grid,/area/space)
"EP" = (/obj/effect/decal/cleanable/oil/streak,/obj/effect/decal/cleanable/dirt/dust,/turf/open/floor/plasteel/tech,/area/space)
"EX" = (/obj/structure/fence/corner,/turf/open/floor/plating/asteroid/snow/icemoon,/area/overmap_encounter/planetoid/cave/explored)
"EZ" = (/obj/machinery/door/window/brigdoor/eastright,/obj/effect/decal/cleanable/dirt/dust,/turf/open/floor/plasteel/mono/dark,/area/space)
"Fr" = (/obj/effect/turf_decal/techfloor/orange,/turf/open/floor/plating/airless,/area/space)
"FF" = (/obj/effect/turf_decal/techfloor/orange{dir = 6},/turf/open/floor/plating/airless,/area/space)
"FR" = (/obj/machinery/atmospherics/pipe/simple/scrubbers/hidden/layer4{dir = 8},/turf/closed/wall/r_wall/rust,/area/space)
"Ge" = (/obj/effect/decal/cleanable/blood/hitsplatter{dir = 4},/obj/effect/decal/cleanable/blood/squirt{dir = 4; pixel_x = 11},/obj/item/reagent_containers/glass/bucket,/obj/effect/decal/cleanable/dirt/dust,/turf/open/floor/plating/rust,/area/space)
"Gf" = (/obj/machinery/atmospherics/pipe/simple/scrubbers/hidden/layer4{dir = 8},/turf/closed/wall/r_wall,/area/space)
"GQ" = (/obj/structure/cable{icon_state = "1-2"},/obj/effect/decal/cleanable/dirt/dust,/turf/open/floor/plasteel/tech/techmaint,/area/space)
"GV" = (/obj/machinery/light/dim/directional/east,/obj/effect/decal/cleanable/dirt/dust,/obj/effect/decal/cleanable/vomit/old,/turf/open/floor/plating/rust,/area/space)
"Hr" = (/obj/effect/turf_decal/techfloor/orange{dir = 4},/turf/open/floor/plating/airless,/area/space)
"Ht" = (/obj/structure/cable{icon_state = "4-8"},/obj/machinery/door/airlock/glass{dir = 8},/turf/open/floor/plasteel/tech/grid,/area/space)
"Iu" = (/obj/structure/sign/poster/official/safety_report{pixel_x = -32},/turf/open/floor/plasteel/tech/grid,/area/space)
"IJ" = (/obj/structure/salvageable/server,/obj/effect/turf_decal/techfloor/orange,/turf/open/floor/plasteel/tech{initial_gas_mix = "ICEMOON_ATMOS"},/area/space)
"Jb" = (/obj/effect/turf_decal/techfloor/orange{dir = 9},/turf/open/floor/plasteel/tech,/area/space)
"Jc" = (/obj/structure/salvageable/server,/obj/effect/turf_decal/techfloor/orange{dir = 1},/turf/open/floor/plasteel/tech{initial_gas_mix = "ICEMOON_ATMOS"},/area/space)
"Jt" = (/obj/effect/spawner/bunk_bed,/turf/open/floor/plasteel/tech/techmaint,/area/space)
"JF" = (/obj/effect/decal/cleanable/dirt/dust,/turf/open/floor/plating/rust,/area/space)
"JV" = (/obj/machinery/door/window/brigdoor/eastright,/turf/open/floor/plasteel/mono/dark,/area/space)
"KZ" = (/obj/structure/barricade/wooden/crude,/obj/machinery/atmospherics/pipe/simple/scrubbers/hidden/layer4,/turf/open/floor/plating/airless,/area/space)
"Lu" = (/mob/living/simple_animal/hostile/poison/giant_spider/hunter/ice,/turf/open/floor/plating/airless,/area/space)
"LI" = (/obj/structure/salvageable/computer{dir = 1},/turf/open/floor/plasteel/tech,/area/space)
"Ng" = (/obj/machinery/light/dim/directional/east,/obj/effect/decal/cleanable/dirt/dust,/obj/effect/decal/cleanable/greenglow,/obj/machinery/atmospherics/components/unary/passive_vent/layer4{dir = 4},/turf/open/floor/plasteel/mono/dark{initial_gas_mix = "ICEMOON_ATMOS"},/area/space)
"Nl" = (/obj/structure/table,/obj/item/clothing/gloves/fingerless{pixel_y = 6; pixel_x = -3},/obj/item/stack/sheet/mineral/plasma,/obj/item/gun/ballistic/revolver/shadow/no_mag,/obj/effect/decal/cleanable/dirt/dust,/turf/open/floor/plating/airless,/area/space)
"Ns" = (/obj/structure/sign/poster/contraband/tools{pixel_x = -32},/obj/effect/turf_decal/techfloor/orange{dir = 4},/obj/structure/cable{icon_state = "4-10"},/turf/open/floor/plating/airless,/area/space)
"Nw" = (/obj/effect/decal/cleanable/oil/slippery,/obj/effect/decal/cleanable/dirt/dust,/obj/structure/chair/plastic{dir = 1},/turf/open/floor/plasteel/tech,/area/space)
"NV" = (/obj/structure/mirror{broken = 1},/turf/closed/wall/r_wall,/area/space)
"NX" = (/obj/structure/mopbucket,/obj/item/mop,/obj/effect/decal/cleanable/dirt/dust,/obj/effect/decal/cleanable/cobweb/cobweb2,/turf/open/floor/plating/airless,/area/space)
"Oc" = (/obj/structure/curtain,/obj/machinery/shower{pixel_y = 16},/obj/structure/toilet{dir = 4},/turf/open/floor/plasteel/freezer,/area/space)
"OM" = (/obj/machinery/portable_atmospherics/canister/fuel,/obj/effect/turf_decal/industrial/hatch/yellow,/obj/effect/decal/cleanable/dirt/dust,/turf/open/floor/plasteel/tech,/area/space)
"OQ" = (/obj/structure/flora/rock/pile/icy,/turf/open/floor/plating/asteroid/snow/icemoon,/area/overmap_encounter/planetoid/cave/explored)
"Pa" = (/obj/structure/flora/grass/brown,/turf/open/floor/plating/asteroid/snow/icemoon,/area/overmap_encounter/planetoid/cave/explored)
"PS" = (/obj/machinery/door/airlock{dir = 4},/turf/open/floor/plasteel/tech/grid,/area/space)
"PT" = (/obj/effect/spawner/bunk_bed,/turf/open/floor/plating/rust,/area/space)
"PW" = (/obj/effect/turf_decal/techfloor/orange{dir = 1},/obj/effect/decal/cleanable/dirt/dust,/obj/structure/frame/machine,/obj/item/circuitboard/machine/telecomms/server,/obj/item/stack/cable_coil/yellow{pixel_x = 1; pixel_y = -2; amount = 2},/turf/open/floor/plasteel/tech{initial_gas_mix = "ICEMOON_ATMOS"},/area/space)
"Qa" = (/turf/template_noop,/area/template_noop)
"Qn" = (/obj/effect/decal/cleanable/dirt/dust,/turf/open/floor/plasteel/tech/techmaint,/area/space)
"QC" = (/obj/effect/turf_decal/siding/thinplating{dir = 8},/obj/effect/decal/cleanable/dirt/dust,/obj/structure/chair/plastic{dir = 8},/turf/open/floor/plasteel/mono/dark,/area/space)
"QM" = (/obj/effect/mob_spawn/human/corpse/charredskeleton,/obj/effect/decal/cleanable/dirt/dust,/turf/open/floor/plating/airless,/area/space)
"Ro" = (/obj/effect/decal/cleanable/dirt/dust,/turf/open/floor/plasteel/tech,/area/space)
"Rv" = (/obj/effect/decal/cleanable/blood/footprints{dir = 8; pixel_x = -22},/obj/effect/decal/cleanable/blood/splatter{pixel_x = -2; pixel_y = 6},/obj/effect/decal/cleanable/blood/innards{pixel_y = 7; pixel_x = 6},/obj/effect/decal/cleanable/dirt/dust,/obj/item/melee/knife/shiv{pixel_y = -6; pixel_x = 7},/obj/item/wirecutters{pixel_y = 4; pixel_x = -1},/turf/open/floor/plasteel/tech,/area/space)
"RQ" = (/obj/structure/salvageable/server,/obj/effect/turf_decal/techfloor/orange,/obj/effect/decal/cleanable/dirt/dust,/turf/open/floor/plasteel/tech{initial_gas_mix = "ICEMOON_ATMOS"},/area/space)
"Sl" = (/obj/effect/turf_decal/siding/wood{dir = 1},/obj/effect/turf_decal/siding/wood,/obj/structure/cable{icon_state = "4-8"},/obj/effect/decal/cleanable/dirt/dust,/turf/open/floor/wood,/area/space)
"Ss" = (/obj/structure/flora/stump,/turf/open/floor/plating/asteroid/snow/icemoon,/area/overmap_encounter/planetoid/cave/explored)
"UJ" = (/obj/machinery/door/airlock/external{dir = 4},/turf/open/floor/plasteel/tech/grid,/area/space)
"Vd" = (/obj/effect/turf_decal/siding/wood{dir = 1},/obj/effect/turf_decal/siding/wood,/obj/structure/cable{icon_state = "4-9"},/obj/machinery/light/dim/directional/south,/obj/effect/decal/cleanable/dirt/dust,/turf/open/floor/wood,/area/space)
"Wm" = (/turf/closed/wall/r_wall/rust,/area/space)
"Xo" = (/turf/open/floor/plating/rust,/area/space)
"Xt" = (/obj/effect/turf_decal/techfloor{dir = 5},/obj/effect/turf_decal/spline/fancy/opaque/red{dir = 5},/obj/structure/closet/secure_closet,/obj/item/ammo_box/a44roum/hp,/obj/effect/decal/cleanable/blood/gibs/old,/obj/effect/mob_spawn/human/corpse/nanotrasensoldier{brute_damage = 200},/obj/effect/decal/cleanable/dirt/dust,/turf/open/floor/plasteel/tech,/area/space)
"Xw" = (/obj/item/wallframe/camera{pixel_x = -6; pixel_y = 6},/obj/item/stack/cable_coil/yellow{pixel_x = 1; pixel_y = -2; amount = 2},/obj/effect/decal/cleanable/dirt/dust,/obj/effect/turf_decal/techfloor,/turf/open/floor/plasteel/tech/grid,/area/space)
"XD" = (/obj/structure/closet/toolcloset/empty,/obj/item/wrench,/obj/item/clothing/suit/space/engineer,/obj/item/reagent_containers/food/drinks/beer/light,/turf/open/floor/plasteel/tech/techmaint,/area/space)
"XJ" = (/obj/effect/turf_decal/techfloor/orange/corner,/obj/structure/cable{icon_state = "5-8"},/obj/structure/cable{icon_state = "6-8"},/obj/item/t_scanner,/turf/open/floor/plating/airless,/area/space)
"Yy" = (/obj/machinery/atmospherics/pipe/simple/scrubbers/hidden/layer4,/turf/open/floor/plating/airless,/area/space)
"YJ" = (/obj/machinery/vending/engineering,/turf/open/floor/plasteel/tech,/area/space)
"YO" = (/obj/structure/barricade/wooden,/obj/effect/decal/cleanable/dirt/dust,/turf/open/floor/plating/airless,/area/space)
"YQ" = (/obj/item/storage/firstaid/regular{pixel_y = 17; pixel_x = -5},/obj/structure/table,/obj/item/organ/eyes/robotic,/obj/item/organ/tongue/robot{pixel_x = 13; pixel_y = 5},/turf/open/floor/plasteel/tech,/area/space)
"Zx" = (/turf/open/floor/plating/snowed/temperatre{initial_gas_mix = "ICEMOON_ATMOS"},/area/overmap_encounter/planetoid/cave/explored)
"ZO" = (/obj/structure/salvageable/safe_server,/obj/effect/turf_decal/techfloor/orange{dir = 1},/obj/effect/decal/cleanable/dirt/dust,/obj/effect/decal/cleanable/cobweb/cobweb2,/obj/structure/cable{icon_state = "0-10"},/obj/machinery/power/apc/auto_name/directional/north,/turf/open/floor/plasteel/tech{initial_gas_mix = "ICEMOON_ATMOS"},/area/space)

(1,1,1) = {"
QaQaQaQaQaQaQaQaQaQaQaQaQaQaQaQaQatqtqtqtqtqQaQaQaQaQaQaQaQa
QakpkpkpkpkpkpkpQaQaQaQaQaQaQatqtqtqtqtqtqtqtqtqtqQaQaQaQaQa
kpkpkpkpSsPakpkpkpPakpQatqtqtqtqtqtqtqtqtqtqtqtqtqtqtqQaQaQa
kpkpkpkpkpOQtqtqtqtqtqtqtqtqtqtqtqtqtqtqtqtqtqtqtqtqtqtqtqQa
kpkpkpBwmHtqtqtqtqtqtqtqtqtqtqtqtqtqtqkpkptqtqtqtqtqtqtqtqQa
kpkpPakptqtqtqtqtqtqtqkpkpkpWmfBfBWmWmWmWmkpkptqtqtqtqtqtqQa
QakptqtqtqtqtqtqfBfBWmWmWmWmWmYQBcYJWmcmWmkpkpkptqtqtqtqtqtq
tqtqtqtqtqfBfBNVfBgsXDPTwGWmcHNwEPRobQRvWmkplTtqtqtqtqtqtqtq
tqtqtqtqtqfBOczGPSQnJFEyGVfBOMRoeOLIfBRofBahWmfBWmWmWmtqtqtq
tqtqtqtqfBfBfBfBfBQnqjeuJtfBfBDYfBfBfBhefBeeJFYOJFdLWmtqtqtq
QatqtqtqfBAnaHXtfBIufLfLfLfLQnvjhQjYytFrfBfBfBfBQMJFfBtqtqtq
QaQatqtqfBpbAajwovCWddbacgbmAvvjufjYHrJboUPWZOfBJFLuWmqptqtq
QaQatqtqfBgzgzgzfBnlVdSlaSHtiRvjQCjYHrdhEZkzNgGfCAaEFRfmkpkp
QaQatqtqtqZxZxZxfBfBfLfLfLfLmAtgfBfBNslHBDRQRQfBYyeeWmlTkptq
QaQaQatqtqtqZxpwwEfBlbXwfLgdyPQncBXJFFfBfBfBfBfBKZfBfBkptqtq
QaQaQatqtqtqZxZxZxsOQnvjUJvjGQiNjYHrDCgZJcJcfBalDofBkpkptqtq
QaQaQatqtqtqZxZxwEfBqiENfLcalDQnjYHrdhJVtbCeGfDcfBfBkptqtqQa
QaQaQatqtqlTZxZxfBfBfBfBfLfLgVfLfBgBtvqAjXIJfBEyjnfBkptqtqtq
QaQaQatqtqmHkpkpubtqtqWmmToOiKNXfBfBfBfBfBfBfBXoXofBtqtqtqtq
QaQatqtqtqkpSskpkpkptqWmjhGexNNlhBXoXoEyEyEyXoEyXoWmtqtqtqtq
QaQatqtqtqkpkpkpkpkpPahRWmfBfBWmWmWmWmWmfBfBWmWmWmWmtqtqtqQa
QaQatqtqtqtqPakpkpkpkpaOvVtqtqtqtqtqkpkpkpkpkpkptqtqtqtqQaQa
QaQaQaQatqtqtqtqdJlwdJEXkplTtqtqtqtqtqkptqtqtqtqtqtqtqQaQaQa
QaQaQaQaQaQaQakpkpkpkpkpkpkpSstqtqtqtqtqtqtqtqtqtqQaQaQaQaQa
QaQaQaQaQaQaQaQakpkpkpkpkpkpQaQaQaQaQatqtqtqtqQaQaQaQaQaQaQa
"}
